[11 15]
XXXXXXXXXXX
X H       X
XX       XX
X   D R   X
X...R.R...X
X.........X
X         X
X  R   R  X
X..XWWWX..X
X..     ..X
X..     ..X
X..     ..X
X.........X
X.........O
XXXXXXXXXXX
