[11 15]
XXXXXXXXXXX
X H       X
XXX     XXX
X         X
X...R.R...X
X.........X
X         X
X  R   R  X
X..XWWWX..X
X..     ..X
X..     ..X
X..     ..X
X.........X
X.........X
XXXXXXXXXXX
